PPPPPPPPPPPPPPPPPPPPPPPPPPPPPP
QCCCCCCCCCCCCCCCCCCCCCCCCCCCCP
PPPPPPPPPPPPPPPPPPPPPPPPPPPPCP
PCCCCCCCCCCCCCCCCCCCCCCCCCCPCP
PCPPPPPPPPPPPPPPPPPPPPPPPPCPCP
PCPCCCCCCCCCCCCCCCCCCCCCCPCPCP
PCPCPPPPPPPPPPPPPPPPPPPPCPCPCP
PCPCPCCCCCCCCCCCCCCCCCCPCPCPCP
PCPCPCPPPPPPPPPPPPPPPPCPCPCPCP
PCPCPCPCCCCCCCCCCCCCCPCPCPCPCP
PCPCPCPCPPPPPPPPPPPPCPCPCPCPCP
PCPCPCPCPCCCCCCCCCCPCPCPCPCPCP
PCPCPCPCPCPPPPPPPPCPCPCPCPCPCP
PCPCPCPCPCPCCCCCCPCPCPCPCPCPCP
PCPCPCPCPCPCPCCCCPCPCPCPCPCPCP
PCPCPCPCPCPCPCCCCPCPCPCPCPCPCP
PCPCPCPCPCPCPCCCCPCPCPCPCPCPCP
PCPCPCPCPCPCPPPPPPCPCPCPCPCPCP
PCPCPCPCPCPCCCCCCCCPCPCPCPCPCP
PCPCPCPCPCPPPPPPPPPPCPCPCPCPCP
PCPCPCPCPCCCCCCCCCCCCPCPCPCPCP
PCPCPCPCPPPPPPPPPPPPPPCPCPCPCP
PCPCPCPCCCCCCCCCCCCCCCCPCPCPCP
PCPCPCPPPPPPPPPPPPPPPPPPCPCPCP
PCPCPCCCCCCCCCCCCCCCCCCCCPCPCP
PCPCPPPPPPPPPPPPPPPPPPPPPPCPCP
PCPCCCCCCCCCCCCCCCCCCCCCCCCPCP
PCPPPPPPPPPPPPPPPPPPPPPPPPPPCP
PCCCCCCCCCCCCCCCCCCCCCCCCCCCCP
PPPPPPPPPPPPPPPPPPPPPPPPPPPPPP