PPPPPPPPPPPPPPPPPPPPPPPPPPPPPPPPPPPPPPPP
PCCCCCPPPCPPPCPPCCCCCCCCPCPPPPPPPPPCCCCP
PCCCCCPPCCCCCCCCCPCPPPPCCCCCCCCCCCCCPPPP
PCCCCCPCCPPPPPPPPPPPPCPPPCPCPPPCPPPCPCPP
PCPPPPPCPCCCCCCPPCCPCCPPPCPPPPPCPCCPPCPP
PCPPPPPPPPPPPPCPPCPPPCPPPPPCCCCCCCCPCCPP
PCCCCCCCCCCCCCCPPCPPPCCCCCPPPPPPPPCPPCCP
PPPPCPPCPPPPCPPCPCPPPPPPPCPPPCPPPPCPPCPP
PPPPPPPCCCCPCCPCPCCCCCCCCCCCCCCCCCCCCCCP
QCCCCCCCPPPCCPPCPCPCPPPPPPCPPPPCPPPPPPCP
PPCPPPPCPPCCPPPCPPPPPPPPPPCPPCPCPPPPPPCP
PPPPCCCCPCCPPPPCCCPPCCCCCCCCCCPCCCCPCCCP
PCCPCPPCPPCPPCCCPPPPPPCPPPPPPPPPPPCPPPCP
PPCCPPPPPCCCCCPPPCPPPPCCCCCCCCCCCPCPPPCP
PCPCCCCCCCPCPPPPCCCCCCCPPPPPPPPPPPPPPCCP
PCPPPPCPPPPCCCCCCPPCPPCPCPCCCCCCCCCPPPPP
PCCCCCCPPPPCPPPPCPPPPPPPCPPPPPPPPPCCCCCP
PPPPPPCPPCCCCPPPCCCCCCCCCCCCCCCCCCCPPPPP
PCCCCPPPPPPPCPPPPPPPPPPPPCPCPPPPPPCPPCPP
PCCCCCCPPPPPCPCCCCCCCCCCCCPCCCPPPPCCCCCP
PCCCCPCCCCCCCPPPPPPPPPPPPPPPPCPPPPPPPPPP
PPPPPPPPCPPPCPPCCCCCCCCPPCCCCCPPPPPPPPPP
PPPPCCCCCPCPCCCPPPPPPPPPPPPPPPCCCCCCCCCP
QCCCCPPPPPCPPPCPCCPCCCCPPPPPPPCPPPPPPPCP
PPPCPPPCCCCPCPCCCPCCPCPCCCCCCPCPCCCCCPCP
PCCCCCCCPPPPCPPPPPPCPCPCCCCCCPCPCPPPCPCP
PPPPPCPPPPPPCCCCCCCCPCPCCCCCCPCPCPCPCPCP
PCCCCCPPPPPPPPPPPPPCPPPCCCCCCPCPCCCPCPCP
PPPPPCCCCCCCCCCCCCCCCPPCCCCCCPCPPPPPCPCP
PPPPPPPPCPPCPPPPPCPPCPCPPPPPCPCCCCCCCPCP
PPPCCCCCCPCCPCCPPPPPCCCCCCPPCPPPPPPPPPCP
PPPPPPPCPPPCCCPCCCCCCPPPPCCCCCCCCCCCCCCP
PPPPPPPPPPPPPPPPPPPPPPPPPPPPPPPPPPPPPPPP