PPPPPPPPPPPPPPPPPPPPPPPPP
PCCCCCPPPCCCCPPPPPPCCCCCP
PCCCCCPPPCCCCCCCCCPCCCCCP
PCCCCCPPPCCCCPPPPCPPPCPCP
PCCCCCPPPCPPPCCCCCPPPCPCP
PCCCCCPPPCPPPCPPPPPCCCPCP
PPPCPPPPPCPPPCCCCCPCPCPCP
PPPCPPPPPCPPPCCCCCCCPCPCP
PPPCPPPPPCPPPCCCCCPPPCPCP
PCCCCCPPPCCCCPPPPPPPPCPCP
PCCCCCPPPCCCCPPPCCCCCCPCP
PCCCCCCCCCCCCPPPCCCCCCPCP
PCCCCCPPPCCCCPPPCCCCCCPCP
PPPCPPPPPPPPPPPPPPPPPPPCP
PPPCPPPPPPPCCCCCCCCCCCCCP
PCCCCCPCCCCCCCCPPPPPCPPPP
PCCCCCPCCCPCCCCPPCCCCCCCP
PCCCCCPCCCPPPPPPPCCCCCCCP
PPPCPPPPPPPPPCCPPCCCCCCCP
QCCCCCCCCCPPPCCCCCCCCCCCP
PPPPPPPPPPPPPPPPPPPPPPPPP