PPPPPPPPPPPPPQPPPPPP
PCPPPCPCCCPCPCPCCCPP
PCCCCCPCPCPCPCCCPCPP
PPPPPCPCPPPCPPPPPCCP
PCCCPCPCCCCCCCCCCCPP
PCCCPCPPCPCPPCPPPCPP
PCCCPCPPCPPCPCPCCCPP
PCPPPCPPCPCCCCPPPCPP
PCCCCCPPCPPPPCPPCCCP
PPCPPPPCCCCCPCPCCPPP
PCCPPCPPCPPCPCPCPCPP
PPCCPCPPCCPCPCPCPCPP
PPCPPCPPCPCCPCPCCCCP
PPCPCCPPCPPCPCPPPCPP
PCCCPCPCCPPCPCCCPCCP
PPCPPCPPPPPCPCPPCCPP
PPCPCCCCCCCCPCPPPCPP
PPCCPPPCPCPPPCPPCPCP
PCPCPPCPPPPCPCPPCPCP
PCPCCCCCCCCCCCPPCCCP
PCPPPCPCPPCPPCPCPPCP
PCCCPCPPCCCPPCPCCPCP
PPPCPCPCPPCPPCPPCCCP
PPCCCCPCCCCPCCCCCPCP
PPPPPPPPPPPPPPPPPPPP